1111111111111111
1000000000000001
1001110000111001
1001000000001001
1001000000100001
1001110000111001
1000000000000001
1000000100000001
1000000000000001
1000001110000001
1111111111111111